认知神经科学|(美) Michael S. Gazzaniga, Richard B. Ivry, George R. Mangun著
向前一步|(美) 谢丽尔·桑德伯格, 尼尔·斯科维尔著
拖延心理学|(美) 简·博克, 莱诺拉·袁著
自控力|(美) 凯利·麦格尼格尔著
爱的艺术|(美) 艾·弗洛姆著
异类|(美) 马尔科姆·格拉德威尔著
单向度的人|(美) 赫伯特·马尔库塞著
莊子今注今譯|陳鼓應注譯
超专注力|洪启嵩, 龚玲慧著
高效能人士的七个习惯|史蒂芬·柯维著
图解相术|徐文祺著
别告诉我你会记笔记|(日) 美崎荣一郎著
4点起床|(日) 中岛孝志著
中国哲学简史|冯友兰著
四書章句集注|(宋) 朱熹撰
明朝一哥王阳明|吕峥著
你的第一本哲学书|(美) 托马斯·内格尔著
理想国|(古希腊) 柏拉图著
理想国|(古希腊) 柏拉图著
西方哲学简史|赵敦华著
心理学与生活|(美) 理查德·格里格, (美) 菲利普·津巴多著
怪诞心理学. 2. , 探索你的超能力|(英) 理查德·怀斯曼著
心理学导论|(美) Dennis Coon, John O. Mitterer著
36种大脑训练方法提高你的注意力|何启编著
学会提问|(美) 尼尔·布朗, 斯图尔特·基利著
情商|(美) 丹尼尔·戈尔曼著
暗时间|刘未鹏著
高效能人士的七个习惯|(美) 史蒂芬·柯维著
终结拖延症|(美) 威廉·克瑙斯著
黑天鹅|(美) 纳西姆·尼古拉斯·塔勒布著
本色|乐嘉著
塔木德|赛妮亚编译
###哲学、宗教
信息简史|(美) 詹姆斯·格雷克著
失控|(美) 凯文·凯利著
如何阅读一本书|(美) 莫提默·J.艾德勒, 查尔斯·范多伦著
围棋基本技术|(日) 杉内雅男  著
吾国教育病理|郑也夫著
共同的底线|秦晖著
人文视野中的图书馆学|中国图书馆学会编
无器械健身|(美) 马克·劳伦, (美) 乔舒亚·克拉克著
囚徒健身|(美) 保罗·威德著
中外扑克牌玩法 100 种|江东子  编
麦克卢汉精粹|(加)埃里克·麦克卢汉,弗兰克·秦格龙编
传播学教程|郭庆光著
阅读推广|赵俊玲, 郭腊梅, 杨绍志主编
医学文献信息检索|主编罗爱静
围棋入门教程|江铸久, 芮乃伟, 江鸣久著
菊与刀|(美) 露丝·本尼狄克特著
菊与刀|(美) 鲁思·本尼迪克特著
菊与刀|(美) 本尼迪克特著
菊与刀|(美) 露丝·本尼迪克特著
菊花与刀|(美) 鲁斯·本尼迪克特著
内容分析法|(美) 丹尼尔·里夫, 斯蒂文·赖斯, 弗雷德里克·G. 菲克著
理解媒介|(加)马歇尔·麦克卢汉著
媒介内容分析法|彭增军著
学术研究|凌晓峰, 杨强著
科学技术论手册|(美) 希拉·贾撒诺夫 ... [等] 编
解码MOOC|李曼丽, 张羽, 叶赋桂等著
如何高效学习|(加) 斯科特·扬著
科场现形记|郑也夫编
清华园风物志|黄延复, 贾金悦
西南联大行思录|张曼菱著
美国大学的通识教育|黄坤锦著
運動生理學|原著Scott K. Powers, Edward T. Howley
足球入门全图解|北京奥莱足球俱乐部编著
肌肉健美训练图解|(法) Fredreic Delavier编著
家庭健美训练图解|(法) Frederic Delavier, Michael Gundill编著
###文化、科学、教育、体育
凸优化|Stephen Boyd, Lieven Vandenberghe著
COMSOL Multiphysics工程实践与理论仿真|王刚, 安琳编著
Origin 9.0科技绘图与数据分析超级学习手册|张建伟编著
矩阵分析与应用|张贤达著
哥德尔、艾舍尔、巴赫|(美)侯世达著
数学建模入门与提高|主编李汉龙... [等]
矩阵分析与应用|张贤达著
概率论与数理统计|陈希孺编著
多元统计分析及R语言建模|王斌会编著
数值分析基础|关治, 陆金甫
ANSYS 14.0有限元分析入门与提高|吕建国, 胡仁喜等编著
有限元分析|张洪才, 何波编著
Origin 8.0应用实例详解|于成龙, 郝欣, 沈清编著
量子力学学习指导|张鹏飞 ... [等] 编著
热力学·统计物理|汪志诚
非线性光学|石顺祥 ... [等] 编著
大学物理学习题讨论课指导 上|沈慧君, 王虎珠
有机波谱学谱图解析|宁永成著
思考的乐趣|顾森著
微积分教程 上|韩云瑞, 扈志明, 张广远编著
复变函数及应用|(美) James Ward Brown, Ruel V. Churchill著
数学分析 v.1|伍胜健编著
应用随机过程|(美) Sheldon M. Ross著
时间序列分析及应用|(美) Jonathan D. Cryer, Kung-Sik Chan著
统计推断|(美) George Casella, Roger L. Berger著
概率论与数理统计教程|茆诗松, 程依明, 濮晓龙编著
运筹学导论|(美) 弗雷德里克·S. 希利尔, 杰拉尔德·J. 利伯曼著
哈佛大学的博弈论课|(美) 罗伯特·道奇著
ANSYS ICEM CFD从入门到精通|丁源, 王清编著
ANSYS 14.0从入门到精通|凌桂龙, 李战芬编著
有限单元法|王勖成编著
数值分析学习指导|关治编
算法艺术与信息学竞赛|刘汝佳, 黄亮著
Mathematica基础与应用|丁大正编著
力学|Л·д·朗道, E. M. 栗弗席兹著
摩擦学原理|温诗铸, 黄平著
理论力学|??.??. 马尔契夫著
结构力学 v.1|龙驭球, 包世华, 袁驷主编
大学物理学 (第三版) 学习辅导与习题解答|张三慧编著
费恩曼物理学讲义|(美) 费恩曼, 莱顿, 桑兹著
COMSOL Multiphysics有限元法多物理场建模与分析|William B. J. Zimmerman, 中仿科技公司主编
Griffiths量子力学概论学习指导与习题解答|胡行, 贾瑜编著
量子力学习题精选与剖析|钱伯初, 曾谨言著
上帝掷骰子吗？|曹天元著
热力学·统计物理 (第三版) 学习辅导书|汪志诚
统计物理学|王诚泰  著
协同学|(德) 赫尔曼·哈肯著
磁学|J.Stohr, H.C.Siegmann著
电动力学|汪德新编著
新概念物理题解 上|赵凯华, 罗蔚茵, 陈熙谋
等离子体物理与聚变能|(美) Jeffrey Freidberg著
等离子体物理原理|马腾才, 胡希伟, 陈银华编著
分子模拟的理论与实践|陈正隆, 徐为人, 汤立达编著
分子动力学模拟的理论与实践|严六明, 朱素华编著
###数理科学和化学
电工技术与电子技术 上|唐庆玉编著
电工技术与电子技术 下 |唐庆玉编著
电路原理|于歆杰, 朱桂萍, 陆文娟编著
电力系统的MATLAB/SIMULINK仿真与应用|编著王晶, 翁国庆, 张有兵
电工技术与电子技术习题解答 上|唐庆玉编著
电工技术与电子技术习题解答 下|唐庆玉编著
电路|原著邱关源
电路原理学习指导与习题集|朱桂萍, 刘秀成, 徐福媛编著
压电铁电物理|王春雷, 李吉超, 赵明磊编著
高温超导体及其强电应用技术|金建勋编著
永磁无刷直流电机技术|谭建成编著
基於COMSOL Multiphysics的MEMS建模及应用|张玉宝, 李强主编
电力系统稳定与控制|(加) Prabha Kundur著
高等电力网络分析|张伯明, 陈寿孙, 严正著
中国智能电网的技术与发展|中国科学院“构建符合我国国情的智能电网”咨询项目工作组
锂离子电池原理与关键技术|黄可龙, 王兆翔, 刘素琴编著
电路|(美) James W. Nilsson, Susan A. Riedel著
电路原理|吴建华, 李华等编著
电路原理导学导敎及习题解答|朱桂萍 ... [等] 编著
电力电子、电机控制系统的建模和仿真|洪乃刚编著
电力电子技术|王云亮主编
电力电子技术|主编王兆安, 刘进军
电机学|李发海, 朱东起编著
电力电子电机控制系统仿真技术|洪乃刚编著
并网双馈异步风力发电机运行控制|贺益康, 胡家兵, Lie Xu(徐烈)著
电机学|孙旭东, 王善铭编著
小型交流伺服电机控制电路设计|(日) 石岛胜著
电化学超级电容器|(加) B. E.康维著
碳材料在超级电容器中的应用|刘玉荣著
风力发电与电力系统|周双喜, 鲁宗相编著
图解电工入门|王世锟编著
电力系统分析|(美) Hadi Saadat著
现代配电系统分析|王守相, 王成山编著
MATLAB/Simulink电力系统建模与仿真|于群, 曹娜编著
电力系统电压稳定性分析|汤涌著
锂离子电池|郭炳[kun] ... [等] 编著
高能量密度锂离子电池|(美) K. E. Aifantis, S. A. Hackney, (英) R. V. Kumar编著
太阳能电池工作原理、技术和系统应用|编著Martin A. Green
太阳电池、LED和二极管的原理|(加拿大) Adrian Kitai著
太阳能电池物理|(英) Jenny Nelson著
太阳能电池基础与应用|熊绍珍, 朱美芳主编
###电工技术
算法导论|(美) Thomas H. Cormen ... [等]著
Fortran 95程序设计|白云 ... [等] 编著
Python基础教程|(挪) Magnus Lie Hetland著
R语言编程艺术|(美) Norman Matloff著
C++ Primer中文版|Stanley B. Lippman, Josée Lajoie, Barbara E. Moo著
编程之美|《编程之美》小组著
程序员修炼之道|(美) Josh Carter著
数据结构|邓俊辉编著
C++ Primer中文版|Stanley B. Lippman, Josee Lajoie, Barbara E. Moo著
C++ Primer Plus (第6版) 中文版|(美) Stephen Prata著
精通MATLAB R2011a|张志涌等编著
Python技术参考大全|Martin C. Brown著
编译原理|(美) Alfred V. Aho ... [等] 著
现代操作系统|(荷) Andrew S. Tanenbaum著
自动控制原理|吴麒 ... [等] 编著
机器学习|(美) Tom M. Mitchell著
神经网络与机器学习|(加) Simon Haykin著
模式识别与智能计算的MATLAB实现|许国根, 贾瑛编著
数据挖掘十大算法|Xindong Wu, Vipin Kumar编著
大数据时代的历史机遇|赵国栋 ... [等] 著
大数据|赵刚著
电脑轻松入门|科教工作室编著
算法导论|(美) Thomas H. Cormen ... [等] 著
改变未来的九大算法|(美) 约翰·麦考密克著
数学之美|吴军著
深入理解计算机系统|(美) Randal E. Bryant, David R. O&#039;Hallaron著
大数据云计算时代数据中心经典案例赏析|(美) Douglas Alger著
数据挖掘|(美) Mehmed Kantardzic著
数据挖掘|Jiawei Han, Micheline Kamber, Jian Pei著
代码大全|(美) Steve McConnell著
R语言实战|(美) Robert I. Kabacoff著
Effective C++|(美) Scott Meyers著
C Primer Plus中文版|(美) Stephen Prata著
C#入门经典(第6版)|Karli Watson ... [等] 著
C语言程序设计习题解析与应用案例分析|黄维通, 谢孟荣编著
C++程序设计|肖守柏, 金欢编著
FORTRAN完全自学手册|陈科等编著
新编FORTRAN 90程序设计敎程|编著白云, 李学哲, 贾波
FORTRAN 95程序设计与数据结构基础教程|王保旗主编
Scala编程|Martin Odersky, Lex Spoon, Bill Venners著
精通MATLAB最优化计算|龚纯, 王正林编著
MATLAB函数速查手册|李玉莉等编著
精通Matlab与C/C++混合程序设计|刘维编著
MATLAB 8.0从入门到精通|温正编著
MATLAB从入门到精通|周建兴 ... [等] 编著
MATLAB基础教程|孙蓬主编
MATLAB实用教程|主编朱元泽, 李贤彬
Head First Python|Paul Barry著
Python核心编程|(美) Wesley J. Chun著
Python网络编程基础|(美) John Goerzen著
Verilog HDL数字系统设计入门与应用实例|王秀琴, 夏洪洋, 张鹏南编著
操作系统概念|(美) Abraham Silberschatz, Peter Baer Galvin, Greg Gagne著
Windows 7操作系统使用详解|杰创文化编著
Linux入门很简单|刘金鹏等编著
Word 2007办公应用从新手到高手|唐有明, 孙岩, 周保英等编著
OpenCV 2计算机视觉编程手册|(加) Robert Laganière著
MATLAB图像处理从入门到精通|马晓路 ... [等] 编著
中文版Photoshop CS6从入门到精通|彭小霞, 何晓琴编著
GPU高性能编程CUDA实战|(美) Jason Sanders, Edward Kandrot著
推荐系统实践|项亮编著
###自动化技术、计算机技术
Verilog数字系统设计教程|夏宇闻编著
实用数字信号处理|(美) Steven W. Smith著
帮你学模拟电子技术基础|华成英主编
Android编程入门很简单|王勇等编著
轻松实现Altium Designer板级设计与数据管理|王正勇编著
Altium Designer Summer 09从入门到精通|周冰, 李田, 胡仁喜等编著
信号与系统|郑君里, 应启珩, 杨为理
数字图像处理|(美) Rafael C. Gonzalez, Richard E. Woods, Steven L. Eddins著
疯狂iOS讲义 上|李刚编著
疯狂Android讲义|李刚编著
模拟电子技术基础|华成英, 童诗白主编
半导体器件物理|(美) 施敏, 伍国珏著
半导体制造技术|(美) Michael Quirk, (美) Julian Serda著
Altium Designer 10入门与PCB设计实例|王建农, 王伟编著
Altium Designer原理图与PCB设计|周润景, 郝媛媛编著
乐享Arduino + Android创意制作|(美) Mike Riley著
ADS2008射频电路设计与仿真实例|徐兴福主编
信号与系统|(美) Alan V. Oppenheim, Alan S. Willsky, S. Hamid Nawab著
信号与系统 (第三版) 习题解析|谷源涛
数字信号处理 (MATLAB版)|(美) 维纳·K·英格尔, 约翰·G·普罗克斯
数字信号处理|姚天任编著
精通Matlab数字图像处理与识别|张铮 ... [等] 编著
Matlab/Simulink通信系统建模与仿真实例分析|邵玉斌编著
Android应用开发深入学习实录|关立勋等编著
精彩绝伦的Android UI设计|Juhani Lehtimaki著
Android编程入门经典|(美) Wei-Meng Lee著
Android基础开发与实践|吴善财编著
###无线电电子学、电信技术
